w,w,w,w,w,w,w,w,w,g0
w,rd,rl,rl,rl,rdl,rl,rl,rl,w
w,rdr,pl,pr,rul,rdr,pl,pr,rul,w
w,rdr,pl,pr,rul,rdr,pl,pr,rul,w
w,rdr,pl,pr,rul,rdr,pl,pr,rul,w
w,rdr,pl,pr,rul,rdr,pl,pr,rul,w
w,rdr,pl,pr,rul,rdr,pl,pr,rul,w
x0,rlr,pl,pr,rul,rdr,pl,pr,rul,w
er,rr,rr,rr,rur,rr,rr,rr,ru,w
w,w,w,w,w,w,w,w,w,w
